Test
An Interactive Fiction by lekstonjm
Release 1 / Serial number 191109 / Inform 7 build 6M62 (I6/v6.33 lib 6/12N) SD

World
Test room

You can see a Poster here.

>help
That's not a verb I recognise.

>exit
But you aren't in anything at the moment.

>quit
Are you sure you want to quit?

>yes
[ The game has finished ]

* * *

Test
An Interactive Fiction by lekstonjm
Release 1 / Serial number 191109 / Inform 7 build 6M62 (I6/v6.33 lib 6/12N) SD

World
Test room

You can see a Poster here.

>tell Sybil hello
I didn't understand that sentence.

>tell Sybil about hello
There is no reply.

>tell Sybil about persians
She nods gravely.

* * *

Test
An Interactive Fiction by lekstonjm
Release 1 / Serial number 191109 / Inform 7 build 6M62 (I6/v6.33 lib 6/12N) SD

World
Test room

You can see a Poster here.

>tell Sybil about Hello
Hello world!

>tell Sybil Hello
I didn't understand that sentence.

* * *

Test
An Interactive Fiction by lekstonjm
Release 1 / Serial number 191109 / Inform 7 build 6M62 (I6/v6.33 lib 6/12N) SD

World
Test room

You can see a Poster here.

>examin the Poster
That's not a verb I recognise.

>read the Poster
Hello world!